%%%%%%%%%
% .. .. %
%.     .%
% %% %% %
% o%G%o %
%.%%%%%.%
%. P P .%
%%%%%%%%%
