%%%%%%%
% P   %
% %%% %
% %. P%
% %%% %
%. G  %
%%%%%%%
