%%%%%%%
%P    %
% %%% %
% %. P%
% %%% %
%. G  %
%%%%%%%
