%%%%%%%%%%%%%%%%%%%%
%......%  G %......%
%.%%...%%  %%...%%.%
%.%o.%....P...%.o%.%
%.%%.%.%%%%%%.%.%%.%
%P..G..............%
%%%%%%%%%%%%%%%%%%%%
