%%%%%%%
%G.   %
%o G  %
% o  .%
%. .  %
%    .%
%  .  %
% P   %
%P .  %
%%%%%%%
