%%%%%%%%%%%%%%%%%%%%
%......%G  G%.P....%
%.%%...%%  %%...%%.%
%.%o.%........%.o%.%
%.%%.%.%%%%%%.%.%%.%
%P.................%
%%%%%%%%%%%%%%%%%%%%
