%%%%%%%%%%%%%%%%%%%%
%......%  G %......%
%.%%...%%  %%...%%.%
%.%o.%........%.o%.%
%.%%.%.%%%%%%.%.%%.%
%P..G.....P........%
%%%%%%%%%%%%%%%%%%%%
