%%%%%%%
%     %
% %%% %
% %. P%
% %%% %
%. G  %
%%%%%%%
