%%%%%%%%%%%%%%%%%%%%
%......%  G %......%
%.%%...%%  %%...%%.%
%.%o.%........%.o%.%
%.%%.%.%%%%%%.%.%%.%
%P..G..............%
%%%%%%%%%%%%%%%%%%%%
